###############
# @           #
#.###########.#
2.# ....... #.1
#.# ####### #.#
#             #
# #.### ###.# #
# #.#gg gg#.# #
# #.#######.# #
#             #
#.#### ## ###.#
1.# ....... #.2
#.# ####### #.#
#             #
###############